111111111111111111111111111111111
1CCCCCCCCCCCCCCCCCCCCCCCCCCCCCPb1
1C1111111111111111111111111111111
1CCCCCCCCCCCCCCCCCCCCCCCCCCCCCCC1
1111111111111111111111111111111C1
1ECCCCCCCCCCCCCCCCCCCCCCCCCCCCCC1
111111111111111111111111111111111