1111111111111111111111111111111111111
1E10000100000000001001111100000000001
10CP000011111100100001111000000000001
1111100000000000000000111000000111001
1000111010b00111000000000000001111101
1000111010100111000000000000001111101
1111100000000000000000111000000111001
1110000011111100100001111000000000001
1111111111111111111111111111111111111