1111111111111111
1EP0000010000001
1000000011111101
1111100000000001
10001110100I1111
1111111111111111