11111111111111111111111111
10000000000000p00000000001
10000000000000000000i00001
111111111000000000i0000001
1000b0001000000000000i0001
1PCCCCCCCCCCCCCCCCCC000001
11111111111111111111111111