11111111111111111111111111
10000000000000p00000000001
10000000000000000000000001
11111111100000000000000001
10000000100000000000000001
1bCCCCCCCCCCCCCCCCCC000001
11111111111111111111111111