11111111111111111111111111
10000000000000p10000000001
10000000001111110011111101
11111111100000i01010000001
10000000101111111010001111
1b011110001000000011100001
10010011111011111110010001
10011000000010000000001001
100i0011111110000i00000001
11111111111111111111111111