11111111111111111111111111
1E000000P00000100000000001
10000000000000000011111101
11111111100000001010000001
10000000101111111010001111
10011110001000000011100001
10010011111011110110010001
10011000000000000000001111
1IIIII1111111IIIIIIIII1b11
11111111111111111111111111