11111111111111111111111111
10000000000000000000000001
10000000000001000000000001
11111111100001000000000001
10000000111111000000000001
10000000000000000000000001
11111111111111111111111111