1111111111111111111111111111111111111
1E10000100000000001001111100000000001
1P00000011111100100001111000000000001
1111100000000000000000111C00000111001
1000111010b001110000000000000011111C1
1000111010100111000000000000001111101
1111100000000000000000111C00000111001
1110000011111100100001111000000000001
1C00000000000011111000000000000000001
1111111111111111111111111111111111111