MMMMMMMMMMMMMMMMMMMMMMMMMM
11111111111111111111111111
1E000000p00000100000000001
1000000000000000011111101
11111111100000i01010000001
10000000101111111010001111
10011110001000000011100001
10010011111011110110010001
10011000000000000000001001
100i0011111110000i00000b01
11111111111111111111111111